#####
#   #
# $ #
#.@ #
#####
