#######################
#@#      #        #  .#
# # #### #### # # ## $#
# # #  #  # # # # #   #
#   #  ## #   # # ## ##
######  # # # # # #   #
#         ##### # ### #
#### # ##       # ### #
#    # ## ##### # ### #
# #### #  ### # # ### #
# #### ###### #       #
# #### ###### #  #### #
#         #         # #
#######################