#########
#       #
# . $ . #
#   @   #
# $   $ #
# .   . #
#       #
#########
