###################################
#   #           #   #       #     #
### ####### ### # ### ### # # # # #
# # #       # # #   # #   # # # # #
# # # ####### # # # # # ### ### ###
# #   #       # # #   # # #   #   #
# ##### ##### # ##### # # ### # # #
#       #   # #     # # #     # # #
# ####### # ####### ### # ####### #
# #       #       # #   #         #
# # ########### # # # ########### #
# # #   #   #   # # #           # #
# # # ### # # ### # ### ####### ###
# # #   # #   #   #   #   #   #   #
# # # # # ##### ##### # ### # ### #
# # # # # #   # #     # #   #     #
# # ### # # # # # ####### ####### #
# #     # # # # # #       #     # #
# ##### # # # ### # #######$### # #
#       #   #       #      .  #   #
###################################