#########
#       #
#   $ . #
#   @   #
# $   $ #
# .   . #
#       #
#########
