#######
#     #
# #$# #
# #.# #
# $@#.#
#     #
#     #
#######