############
#          #
#          #
#          #
#       .  #
#     $    #
#  @       #
#          #
#          #
############