############
#@      .###
##  #$## ###
# $ #  #$ .#
# . # #    #
##$## #$ $.#
# . $ #.#  #
#.    #    #
############